0 1 1 1 1 1 1 1 1 1 1 1 1 1 1 2
16 17 17 17 17 17 17 17 17 17 17 17 17 17 17 18
16 17 17 17 17 17 17 17 17 17 17 17 17 17 17 18
16 17 17 17 17 17 17 17 17 17 17 17 17 17 17 18
16 17 17 17 17 17 17 17 17 17 17 17 17 17 17 18
16 17 17 17 17 17 17 17 17 17 17 17 17 17 17 18
16 17 17 17 17 17 17 17 17 17 17 17 17 17 17 18
16 17 17 17 17 17 17 17 17 17 17 17 17 17 17 18
16 17 17 17 17 17 17 17 17 17 17 17 17 17 17 18
16 17 17 17 17 17 17 17 17 17 17 17 17 17 17 18
16 17 17 17 17 17 17 17 17 17 17 17 17 17 17 18
16 17 17 17 17 17 17 17 17 17 17 17 17 17 17 18
16 17 17 17 17 17 17 17 17 17 17 17 17 17 17 18
16 17 17 17 17 17 17 17 17 17 17 17 17 17 17 18
16 17 17 17 17 17 17 17 17 17 17 17 17 17 17 18
32 9 9 9 9 9 9 9 9 9 9 9 9 9 9 34